####################
#..................#
#..................#
#..................#
#......P.....P.....#
#..................#
#..................#
#........S.........#
#..................#
#..................#
#..................#
####################